  
 
F   255,0,0
SO        ./textures/so.png
NO		./textures/no.png

C     50,50,255
		EA  ./textures/ea.png
WE    ./textures/we.png
             

	

  1111111111111111111
  1000000000000000001
111000000000000000001
10000011000000S000001
100000110000000000111
100000000000000000001  
100000000000000000111 
1000000000000000001  
1111111111111111111  

