  
 NO   ./textures/no.png	

F   255,0,0
C     50,50,255

WE    ./textures/we.png
SO        ./textures/so.png
             
		EA  ./textures/ea.png
	


  1111111111111111111
  1000000000000000001
110000000000000000001
10000011000000E000001
100000110000000000111
1000000000000000001  
1000000000000000001  
1000000000000000001  
1111111111111111111  
