  
 
F   255,0,0
C     50,50,255
NO   ./textures/no.png

WE    ./textures/we.png
SO        ./textures/so.png
             
		EA  ./textures/ea.png
	

111111111  111111111111111111111
100000001  100000000000000000001
100000001  1000000000000N0000001
10000000111100000000000000001111
111000000000000000000000000011
  10000000000000000000000000011
11100000000000000000110000000001
10000000000000000000110000000001
11111000111111111111110000000001
11111000111111111111110000000001
10000000000000000000000000000001
10000000000111111111111110000001
10000000001             10000001
10000000001            100000001
1000000001111111111111 100000001
1100000000000000000011  1111111 
1100000000000000000001
1111111111111111111111
