  
 
	F   25,    12,160
SO        ./textures/so.png
	NO	./textures/no.png

C     157	,96,	230
		EA   ./textures/ea.png
	WE    ./textures/we.png
             

	
  1111111111111111111
  1000000000000000001
  1000000000000000001
111000000000000000001
100000000000000000001
100000110000000000001
100000110000000000111
100000000000000000001  
100000000000000000001  
100000000001111001111 
1000000000000100001  
1000000000000100001  
1000000000000100N01  
1000000000000100001  
1111111111111111111  
