  
 
F   0,153,0
C     51,153,255
NO   ./textures/no.png

WE    ./textures/we.png
SO        ./textures/so.png
             
		EA  ./textures/ea.png
	

11111111111111111111111111111111 1111111111111111111111
11000000000000000000000000000001  100000000000000000001
11000000000000000000000000000001  100000000000000000001
1100000000000000000000000000000111100000000000000001111
1110000000000000000000000000000000000000000000000001
1110000000000000000000000000000000000000000000000001
1110000000000000000000000000000000000000000000000001
1110000000000000000000000000000000000000000111111111
1110000000000000000000000000000000000000000111111111111
1110000000000000000000000000000000000000000110000000001
1100000000000000000000000000000000000000000110000000001
1111111111110000000000000000000111111111111110000000001
1111111111110000000000000000000111111111111110000000001
1000000000010000000000000000000100000000000000000000001
1000000000010000S00000000000000100000000000000000000001
1000000000010000000000000000000100000000000000000000001
1000000000010000000000000000000000000000000000000000001
1000000000010000000000000000000000000000000000000000001
1000000000010000000000000000000100000000000000000000001
1000000000010000000000000000000100000000000000000000001
1000000000010000000000000000000111111111111111111111111
1000000000010000000000000000000001            110000001
1000000000010000000000000000000001            100000001
100000000001000000000000000000001111111111111 100000001
110000000001000000000000000000000000000000011 111111111 
110000000000000000000000000000000000000000001
111111111111111111111111111111111111111111111










