1111111111
1P000000C1
1C00C000E1
1111111111