11111111111111111
1P000000000000001
1C000C0000000C001
100000000C0000001
100000000E000C001
11111111111111111
