1111111111
10P00C0001
1000000C01
100C000001
100C000001
1C0000C001
10C0000001
1000C00001
1000000E01
1111111111