1111111111111
10C0010000E01
1000000C00001
1010P01000001
111000010C001
1111111111111