11111111
1000C001
10110001
1P01C101
10C00C01
100010E1
100C0001
11111111