111111111
1P000 0C1
1C00E0C01
111111111