111111111
1P000ECC1

111111111